NO ./textures/42_textura_eltxoinas.xpm
SO ./textures/42_textura_ibaines.xpm
WE ./textures/42_textura_jelorria.xpm
EA ./textures/42_textura_marmol.xpm

F 175,127,65
C 89,94,239

        1111111111111111111111111
        1000000000110000000000001
        1011000001110000000000001
        1001000000000000000000001
111111111011000001111000000000001
100000000011000001110111111111111
11110111111111011100000010001
11111111111111011101010010001
11000000110101011100000010001
10000000000000011000000100011
1000W000000000001101010010001
1100000111010101111101111000111
11110111 1110101 101111010001
11111111 1111111 111111111111